A graver is a [MASK]	tool
A smallmouth is a [MASK]	fish
A pelican is a [MASK]	bird
A sapsucker is a [MASK]	bird
A mako is a [MASK]	fish
A stanhope is a [MASK]	vehicle
A redhorse is a [MASK]	fish
A bigeye is a [MASK]	fish
A merganser is a [MASK]	bird
A terebinth is a [MASK]	tree
A speedboat is a [MASK]	vehicle
A limber is a [MASK]	vehicle
A marigold is a [MASK]	flower
A skateboard is a [MASK]	vehicle
A gazebo is a [MASK]	building
A chough is a [MASK]	bird
A steamboat is a [MASK]	vehicle
A finch is a [MASK]	bird
A cafeteria is a [MASK]	building
A helicopter is a [MASK]	vehicle
A scythe is a [MASK]	tool
An eggar is an [MASK]	insect
A woodpecker is a [MASK]	bird
A puffin is a [MASK]	bird
A limpkin is a [MASK]	bird
A penknife is a [MASK]	tool
A stingray is a [MASK]	fish
A myna is a [MASK]	bird
An owl is a [MASK]	bird
A palmetto is a [MASK]	tree
A tamp is a [MASK]	tool
A laelia is a [MASK]	flower
A limousine is a [MASK]	vehicle
A goldcrest is a [MASK]	bird
A sled is a [MASK]	vehicle
A barong is a [MASK]	tool
A vanda is a [MASK]	flower
A stable is a [MASK]	building
A bobolink is a [MASK]	bird
A warplane is a [MASK]	vehicle
A dinghy is a [MASK]	vehicle
An autogiro is a [MASK]	vehicle
A coelogyne is a [MASK]	flower
A thornbill is a [MASK]	bird
A cassowary is a [MASK]	bird
A matai is a [MASK]	tree
A pedicab is a [MASK]	vehicle
A hayfork is a [MASK]	tool
A tuberose is a [MASK]	flower
A roadrunner is a [MASK]	bird
An adz is a [MASK]	tool
A ripsaw is a [MASK]	tool
A parang is a [MASK]	tool
A parsonage is a [MASK]	building
A whaleboat is a [MASK]	vehicle
An imaret is a [MASK]	building
A buckboard is a [MASK]	vehicle
A grosbeak is a [MASK]	bird
A mangrove is a [MASK]	tree
An auk is a [MASK]	bird
A yacht is a [MASK]	vehicle
A glider is a [MASK]	vehicle
A chalet is a [MASK]	building
An odontoglossum is a [MASK]	flower
A shanny is a [MASK]	fish
A burbot is a [MASK]	fish
A marlin is a [MASK]	fish
An oxcart is a [MASK]	vehicle
An acacia is a [MASK]	tree
A dita is a [MASK]	tree
A locomotive is a [MASK]	vehicle
An argentine is a [MASK]	fish
A wrasse is a [MASK]	fish
An ambulance is a [MASK]	vehicle
A hacksaw is a [MASK]	tool
An ironclad is a [MASK]	vehicle
A nigella is a [MASK]	flower
A restaurant is a [MASK]	building
A tinamou is a [MASK]	bird
An alcazar is a [MASK]	building
A peafowl is a [MASK]	bird
A cygnet is a [MASK]	bird
A dredger is a [MASK]	vehicle
A toucanet is a [MASK]	bird
A murre is a [MASK]	bird
An orangery is a [MASK]	building
A ziggurat is a [MASK]	building
A mockernut is a [MASK]	tree
A greenhouse is a [MASK]	building
An ax is a [MASK]	tool
A snowplow is a [MASK]	vehicle
A moth is an [MASK]	insect
A pupa is an [MASK]	insect
A capercaillie is a [MASK]	bird
A salmonid is a [MASK]	fish
A greylag is a [MASK]	bird
A moray is a [MASK]	fish
A tetra is a [MASK]	fish
A macaw is a [MASK]	bird
A swordtail is a [MASK]	fish
A calendula is a [MASK]	flower
A frogmouth is a [MASK]	bird
A hovercraft is a [MASK]	vehicle
A drosophila is an [MASK]	insect
A scarab is an [MASK]	insect
A valerian is a [MASK]	flower
A mallard is a [MASK]	bird
A rammer is a [MASK]	tool
A mayfly is an [MASK]	insect
A mojarra is a [MASK]	fish
A steakhouse is a [MASK]	building
A shed is a [MASK]	building
A corvette is a [MASK]	vehicle
A kinglet is a [MASK]	bird
A dispensary is a [MASK]	building
A dinky is a [MASK]	vehicle
A jackscrew is a [MASK]	tool
A kahikatea is a [MASK]	tree
A cafe is a [MASK]	building
A straightedge is a [MASK]	tool
A chachalaca is a [MASK]	bird
A dreadnought is a [MASK]	vehicle
A tugboat is a [MASK]	vehicle
A coracle is a [MASK]	vehicle
A boxcar is a [MASK]	vehicle
An ailanthus is a [MASK]	tree
A hotel is a [MASK]	building
A barracuda is a [MASK]	fish
A motmot is a [MASK]	bird
A curlew is a [MASK]	bird
A tragopan is a [MASK]	bird
A lifeboat is a [MASK]	vehicle
A fireboat is a [MASK]	vehicle
A subcompact is a [MASK]	vehicle
A botfly is an [MASK]	insect
A cyprinid is a [MASK]	fish
A siskin is a [MASK]	bird
A ginkgo is a [MASK]	tree
A midge is an [MASK]	insect
A pipal is a [MASK]	tree
A cybercafe is a [MASK]	building
A showboat is a [MASK]	vehicle
A carport is a [MASK]	building
A conifer is a [MASK]	tree
A roadhouse is a [MASK]	building
A hearse is a [MASK]	vehicle
A cobia is a [MASK]	fish
An eider is a [MASK]	bird
A barbet is a [MASK]	bird
A killdeer is a [MASK]	bird
A towhee is a [MASK]	bird
A brigantine is a [MASK]	vehicle
A horsecar is a [MASK]	vehicle
A tanager is a [MASK]	bird
A posthouse is a [MASK]	building
A rudd is a [MASK]	fish
A fulmar is a [MASK]	bird
A chunga is a [MASK]	bird
A kea is a [MASK]	bird
A casuarina is a [MASK]	tree
A pigeon is a [MASK]	bird
A scaup is a [MASK]	bird
A canoe is a [MASK]	vehicle
A saltbox is a [MASK]	building
A macadamia is a [MASK]	tree
A woodshed is a [MASK]	building
A rowan is a [MASK]	tree
A minnow is a [MASK]	fish
A tody is a [MASK]	bird
A dogsled is a [MASK]	vehicle
A kookaburra is a [MASK]	bird
A pipit is a [MASK]	bird
A mattock is a [MASK]	tool
A bantam is a [MASK]	bird
A scoter is a [MASK]	bird
A smokehouse is a [MASK]	building
A supertanker is a [MASK]	vehicle
A cotinga is a [MASK]	bird
A sickle is a [MASK]	tool
A skylark is a [MASK]	bird
A neem is a [MASK]	tree
A maxillaria is a [MASK]	flower
A nuthatch is a [MASK]	bird
A bandsaw is a [MASK]	tool
A capelin is a [MASK]	fish
A bonsai is a [MASK]	tree
An ortolan is a [MASK]	bird
A willet is a [MASK]	bird
A hornbeam is a [MASK]	tree
A crookneck is a [MASK]	vegetable
A spacecraft is a [MASK]	vehicle
A gallinule is a [MASK]	bird
A toboggan is a [MASK]	vehicle
A weka is a [MASK]	bird
A dace is a [MASK]	fish
A pumpkinseed is a [MASK]	fish
A cockatoo is a [MASK]	bird
A tansy is a [MASK]	flower
An icepick is a [MASK]	tool
A dahlia is a [MASK]	flower
A pewee is a [MASK]	bird
A pintail is a [MASK]	bird
A pocketknife is a [MASK]	tool
A hardtop is a [MASK]	vehicle
A piculet is a [MASK]	bird
A barge is a [MASK]	vehicle
A sturgeon is a [MASK]	fish
A pagoda is a [MASK]	building
A gnatcatcher is a [MASK]	bird
A currawong is a [MASK]	bird
A sawfly is an [MASK]	insect
An aphid is an [MASK]	insect
A curassow is a [MASK]	bird
A pung is a [MASK]	vehicle
A motel is a [MASK]	building
A chickadee is a [MASK]	bird
An amberjack is a [MASK]	fish
A houseboat is a [MASK]	vehicle
A gavel is a [MASK]	tool
A switchblade is a [MASK]	tool
An opah is a [MASK]	fish
A menhaden is a [MASK]	fish
A corozo is a [MASK]	tree
A yellowfin is a [MASK]	fish
A mealybug is an [MASK]	insect
A serin is a [MASK]	bird
A verbena is a [MASK]	flower
A consulate is a [MASK]	building
A mantis is an [MASK]	insect
A clubhouse is a [MASK]	building
A grebe is a [MASK]	bird
A lightship is a [MASK]	vehicle
A kingfisher is a [MASK]	bird
A warship is a [MASK]	vehicle
A ketch is a [MASK]	vehicle
A verdin is a [MASK]	bird
A conger is a [MASK]	fish
A guan is a [MASK]	bird
A feedlot is a [MASK]	building
A ladybug is an [MASK]	insect
A bowfin is a [MASK]	fish
A greenshank is a [MASK]	bird
A chub is a [MASK]	fish
A dray is a [MASK]	vehicle
A pollinator is an [MASK]	insect
A wildfowl is a [MASK]	bird
A columbine is a [MASK]	flower
A pinon is a [MASK]	tree
A gannet is a [MASK]	bird
A ship is a [MASK]	vehicle
A razorblade is a [MASK]	tool
A bergamot is a [MASK]	tree
An arethusa is a [MASK]	flower
A bulldozer is a [MASK]	vehicle
A larkspur is a [MASK]	flower
A largemouth is a [MASK]	fish
A wagtail is a [MASK]	bird
An escolar is a [MASK]	fish
A peregrine is a [MASK]	bird
A crossbill is a [MASK]	bird
A pitchfork is a [MASK]	tool
A seaplane is a [MASK]	vehicle
A coucal is a [MASK]	bird
A firetrap is a [MASK]	building
An oncidium is a [MASK]	flower
A tench is a [MASK]	fish
A wrymouth is a [MASK]	fish
A chipotle is a [MASK]	vegetable
A rosita is a [MASK]	flower
A phalarope is a [MASK]	bird
A lamasery is a [MASK]	building
A poppy is a [MASK]	flower
A shebeen is a [MASK]	building
A starship is a [MASK]	vehicle
A mosquito is an [MASK]	insect
A cicada is an [MASK]	insect
A rimu is a [MASK]	tree
An areca is a [MASK]	tree
A sulky is a [MASK]	vehicle
An electric is a [MASK]	vehicle
A tautog is a [MASK]	fish
A blowfly is an [MASK]	insect
A caff is a [MASK]	building
A jetliner is a [MASK]	vehicle
A glowworm is an [MASK]	insect
A sallow is a [MASK]	tree
A lightwood is a [MASK]	tree
A rink is a [MASK]	building
An ant is an [MASK]	insect
An arborvitae is a [MASK]	tree
An alehouse is a [MASK]	building
A bunchberry is a [MASK]	tree
A loach is a [MASK]	fish
An abattoir is a [MASK]	building
A trimaran is a [MASK]	vehicle
A troopship is a [MASK]	vehicle
A bethel is a [MASK]	building
A shrimper is a [MASK]	vehicle
A corkscrew is a [MASK]	tool
A forklift is a [MASK]	vehicle
A kurrajong is a [MASK]	tree
A toothpick is a [MASK]	tool
A cichlid is a [MASK]	fish
A carrack is a [MASK]	vehicle
An orchid is a [MASK]	flower
A stupa is a [MASK]	building
A minibike is a [MASK]	vehicle
A catalpa is a [MASK]	tree
A shunter is a [MASK]	vehicle
A salai is a [MASK]	tree
A kennel is a [MASK]	building
A chrysalis is an [MASK]	insect
A stringybark is a [MASK]	tree
A kowhai is a [MASK]	tree
A kirk is a [MASK]	building
A sterculia is a [MASK]	tree
A stonefly is an [MASK]	insect
A dipterocarp is a [MASK]	tree
A veronica is a [MASK]	flower
An umbel is a [MASK]	flower
A mosque is a [MASK]	building
A razor is a [MASK]	tool
A twinjet is a [MASK]	vehicle
A porbeagle is a [MASK]	fish
A battleship is a [MASK]	vehicle
A sampan is a [MASK]	vehicle
A friary is a [MASK]	building
A scalpel is a [MASK]	tool
An inga is a [MASK]	tree
A bicycle is a [MASK]	vehicle
A fleabag is a [MASK]	building
A tricycle is a [MASK]	vehicle
An icehouse is a [MASK]	building
A burin is a [MASK]	tool
A peony is a [MASK]	flower
A hornet is an [MASK]	insect
A bluegill is a [MASK]	fish
A guildhall is a [MASK]	building
A remora is a [MASK]	fish
A toolshed is a [MASK]	building
A calosoma is an [MASK]	insect
A cyclamen is a [MASK]	flower
A synagogue is a [MASK]	building
A scad is a [MASK]	fish
A characin is a [MASK]	fish
A lycaenid is an [MASK]	insect
A housefly is an [MASK]	insect
A liza is a [MASK]	fish
A scraper is a [MASK]	tool
A honeybee is an [MASK]	insect
A hairstreak is an [MASK]	insect
A maul is a [MASK]	tool
A handsaw is a [MASK]	tool
A teashop is a [MASK]	building
A grubby is a [MASK]	fish
A saury is a [MASK]	fish
A trowel is a [MASK]	tool
An immortelle is a [MASK]	flower
A cattleya is a [MASK]	flower
A panicle is a [MASK]	flower
A cockchafer is an [MASK]	insect
A plow is a [MASK]	tool
A chisel is a [MASK]	tool
A flophouse is a [MASK]	building
An awl is a [MASK]	tool
A tarpon is a [MASK]	fish
A katydid is an [MASK]	insect
A rathskeller is a [MASK]	building
A pomfret is a [MASK]	fish
A whitefly is an [MASK]	insect
A floret is a [MASK]	flower
A dragonfly is an [MASK]	insect
A bistro is a [MASK]	building
A gurnard is a [MASK]	fish
A halfbeak is a [MASK]	fish
A charterhouse is a [MASK]	building
A guppy is a [MASK]	fish
A hawkmoth is an [MASK]	insect
A caravansary is a [MASK]	building
A cyme is a [MASK]	flower
A radicchio is a [MASK]	vegetable
A termite is an [MASK]	insect
A threadfin is a [MASK]	fish
A surfperch is a [MASK]	fish
A leafhopper is an [MASK]	insect
A monastery is a [MASK]	building
A presbytery is a [MASK]	building
A cockroach is an [MASK]	insect
A portulaca is a [MASK]	flower
A dendrobium is a [MASK]	flower
A bedbug is an [MASK]	insect
An earwig is an [MASK]	insect
A cleaver is a [MASK]	tool
A coelacanth is a [MASK]	fish
A snapdragon is a [MASK]	flower
A goby is a [MASK]	fish
A dacha is a [MASK]	building
A commelina is a [MASK]	flower
A dragonet is a [MASK]	fish
A morgue is a [MASK]	building
A gatehouse is a [MASK]	building
A begonia is a [MASK]	flower
A yellowthroat is a [MASK]	bird
A handcart is a [MASK]	vehicle
A daisy is a [MASK]	flower
A zinnia is a [MASK]	flower
A stagecoach is a [MASK]	vehicle
A customhouse is a [MASK]	building
A weevil is an [MASK]	insect
A barbu is a [MASK]	fish
A bobwhite is a [MASK]	bird
A statehouse is a [MASK]	building
A soapberry is a [MASK]	tree
A chateau is a [MASK]	building
A flamingo is a [MASK]	bird
A bungalow is a [MASK]	building
A danaid is an [MASK]	insect
A tavern is a [MASK]	building
A pullman is a [MASK]	vehicle
A jackdaw is a [MASK]	bird
A budgerigar is a [MASK]	bird
A padauk is a [MASK]	tree
A boathouse is a [MASK]	building
An unicycle is a [MASK]	vehicle
A caladenia is a [MASK]	flower
A lunchroom is a [MASK]	building
A gunboat is a [MASK]	vehicle
A silene is a [MASK]	flower
A hoe is a [MASK]	tool
A gentian is a [MASK]	flower
A longboat is a [MASK]	vehicle
A shrine is a [MASK]	building
A keelboat is a [MASK]	vehicle
A sculpin is a [MASK]	fish
An apiary is a [MASK]	building
A flea is an [MASK]	insect
An araucaria is a [MASK]	tree
A nagi is a [MASK]	tree
A panzer is a [MASK]	vehicle
A snook is a [MASK]	fish
A totara is a [MASK]	tree
A clusia is a [MASK]	tree
A toadflax is a [MASK]	flower
A bookmobile is a [MASK]	vehicle
A catamaran is a [MASK]	vehicle
An ibis is a [MASK]	bird
A skyscraper is a [MASK]	building
A pratincole is a [MASK]	bird
A tern is a [MASK]	bird
A moorcock is a [MASK]	bird
A siris is a [MASK]	tree
An airship is a [MASK]	vehicle
A wheatear is a [MASK]	bird
A blenny is a [MASK]	fish
A guesthouse is a [MASK]	building
A podocarp is a [MASK]	tree
A canvasback is a [MASK]	bird
A longan is a [MASK]	tree
A cacao is a [MASK]	tree
A nunnery is a [MASK]	building
A brewpub is a [MASK]	building
A goldilocks is a [MASK]	flower
A sheepshead is a [MASK]	fish
A ponderosa is a [MASK]	tree
A candytuft is a [MASK]	flower
A fryer is a [MASK]	bird
A farmhouse is a [MASK]	building
An aviary is a [MASK]	building
An outhouse is a [MASK]	building
A jointer is a [MASK]	tool
A handcar is a [MASK]	vehicle
A cacique is a [MASK]	bird
A stickleback is a [MASK]	fish
A hoatzin is a [MASK]	bird
A guillemot is a [MASK]	bird
An adelgid is an [MASK]	insect
A catkin is a [MASK]	flower
A redbud is a [MASK]	tree
A minelayer is a [MASK]	vehicle
A jaeger is a [MASK]	bird
A razorbill is a [MASK]	bird
A masjid is a [MASK]	building
A minicar is a [MASK]	vehicle
A chancellery is a [MASK]	building
A sailboat is a [MASK]	vehicle
A bumblebee is an [MASK]	insect
An adelie is a [MASK]	bird
A clinid is a [MASK]	fish
An airplane is a [MASK]	vehicle
A shoebill is a [MASK]	bird
A flatcar is a [MASK]	vehicle
A masdevallia is a [MASK]	flower
A calceolaria is a [MASK]	flower
A delphinium is a [MASK]	flower
A raceme is a [MASK]	flower
A streptocarpus is a [MASK]	flower
An auklet is a [MASK]	bird
A raven is a [MASK]	bird
A skiff is a [MASK]	vehicle
A brant is a [MASK]	bird
A damselfly is an [MASK]	insect
An osprey is a [MASK]	bird
A motorboat is a [MASK]	vehicle
A platy is a [MASK]	fish
A minivan is a [MASK]	vehicle
A gyrfalcon is a [MASK]	bird
A lychnis is a [MASK]	flower
A baya is a [MASK]	bird
An owlet is a [MASK]	bird
An archaeopteryx is a [MASK]	bird
A titmouse is a [MASK]	bird
A priory is a [MASK]	building
A spoonbill is a [MASK]	bird
A parakeet is a [MASK]	bird
A moa is a [MASK]	bird
A falcon is a [MASK]	bird
A brasserie is a [MASK]	building
A goatsucker is a [MASK]	bird
A tenement is a [MASK]	building
A minster is a [MASK]	building
A godwit is a [MASK]	bird
A plover is a [MASK]	bird
A whydah is a [MASK]	bird
A toucan is a [MASK]	bird
A whorehouse is a [MASK]	building
A megapode is a [MASK]	bird
A cockerel is a [MASK]	bird
A chaffinch is a [MASK]	bird
A petrel is a [MASK]	bird
A floatplane is a [MASK]	vehicle
A trireme is a [MASK]	vehicle
A hansom is a [MASK]	vehicle
A dhak is a [MASK]	tree
A lugger is a [MASK]	vehicle
A bareboat is a [MASK]	vehicle
A monoplane is a [MASK]	vehicle
A gidgee is a [MASK]	tree
A deodar is a [MASK]	tree
A sternwheeler is a [MASK]	vehicle
An angelim is a [MASK]	tree
A humvee is a [MASK]	vehicle
A snowmobile is a [MASK]	vehicle
A mallee is a [MASK]	tree
A palmyra is a [MASK]	tree
A cladogram is a [MASK]	tree
An aspen is a [MASK]	tree
A shagbark is a [MASK]	tree
A pignut is a [MASK]	tree
A metasequoia is a [MASK]	tree
A rangpur is a [MASK]	tree
A montezuma is a [MASK]	tree
A mamo is a [MASK]	bird
A solan is a [MASK]	bird
A bustard is a [MASK]	bird
A ptarmigan is a [MASK]	bird
A reeve is a [MASK]	bird
A lorikeet is a [MASK]	bird
A hornbill is a [MASK]	bird
A sandpiper is a [MASK]	bird
A bulbul is a [MASK]	bird
A sandgrouse is a [MASK]	bird
A knockabout is a [MASK]	vehicle
An ani is a [MASK]	bird
A condor is a [MASK]	bird
A crake is a [MASK]	bird
A jeep is a [MASK]	vehicle
A buggy is a [MASK]	vehicle
A shearwater is a [MASK]	bird
A sloop is a [MASK]	vehicle
A mailboat is a [MASK]	vehicle
A shrike is a [MASK]	bird
A biplane is a [MASK]	vehicle
A baobab is a [MASK]	tree
An aircraft is a [MASK]	vehicle
A gean is a [MASK]	tree
A luge is a [MASK]	vehicle
